    #    
   ###   
  #####  
 ####### 
####.####
 ####### 
  #####  
   ###   
    #     