  ###  
 ##### 
###.###
#######
#######
 ##### 
  ###  